Jacek : NPCs & Characters in Baldur's Gate 3 presents a list of non-playable characters that can be interacted with and appears in the game. NPCs are characters that add contrast to the game's lore where they provide information, some are categorized as quest givers, while others are categorized as Merchants whom you can trade with or request for certain services. This page covers a full list of all the NPCs in Baldur's Gate 3, you can find detailed information on their location and other related information on each individual page linked below.   

All Baldur's Gate 3 NPCs :    

Nautiloid : Myrnath.Us.Commander Zhalk

Ravaged Beach : Damays.Injured Mind Flayer.Nymessa.Stranded Fisher

Camp : Barcus Wroot.Halsin.Oathbreaker Knight.Raphael.The Absolute.Volo.Withers.Owlbear Cub.Scratch.Mizora.Dame Aylin

Dank Crypt : Gimblebock.Taman.Withers.Quelenna.Warryn.Andorn.Barton.Cefrey.Haseid.Mari.Torgga

Druid Grove : Arabella.Aradin.Arka.Asharak.Apikusis.Arron.Auntie Ethel.Barth.Bex.Cal.Dammon.Danis.Doni.Guex.Kagha.Kanon.Komira.Lia.Mattis.Memnos.Mol.Nadira.Nettie.Okta.Olodan.Rath.Remira.Rolan.Sazza.Umi.Zevlor.Zorru

Secluded Cove : Alfira.Mirkon

Owlbear Nest : Owlbear.Owlbear Cub

Blighted Village : Barcus Wroot.Buthir.Chock.Fank.Fezzerk.Grukkoh.Lump the Enlightened.Ornate Mirror.Scratch

Sacred Pool : Aelar.Apikusis.Elwyn.Inwe.Jeorna.Karrik.Mino.Volo

Inner Sanctum : Kagha.Rath.Findal.Marcoryl.Loic.Nettie

Underground Passage : Findal

Upper City : Koll the Red

Sunlit Wetlands : Andrick.Auntie Ethel.Brynna.Demir.Edowin.Gandrel.Johl.Mayrina

Whispering Depths : Phase Spider.Phase Spiderling.Phase Spider Matriarch

Overgrown Tunnel : Lorin.Efrin.Magron.Blinded Elf.Mask of Terror.Mask of Vengeance.Mask of Regret.Mask of Servitude

The Risen Road : Anders.Benryn.Counsellor Florrick.Cyrel.Flind.Gauntlet Yeva.Karlach.Kith'rak Voss.Olly.Rugan.Rurik.Salazon.Trynn.Counselor Florrick.Frightened Ox.Mirileth.Ephren.Jacek

Goblin Camp : Booyahg Piddle.Crusher.Grat the Trader.Gribbo.Krolla.Novice Andrick.Novice Brynna.Novice Crusher.Owlbear Cub.Sentinel Olak.Stimk.Volo.Eight.Five.Four.Bao'ek'nuk.Booyahg Culk.Brawler Tiny.Brawler Rancer.Brawler Rot.Devout Wasp.Devout Mezzka.Guard Gurgon.Klaw

Shattered Sanctum : Abdirak.Cave Bear.Dror Ragzlin.Liam.Minthara.Roah Moonglow.Torturer Spike.True Soul Gut.Warrior Trinzas.Volo.Brakkal.Priestess Gut.Polma

Zhentarim Hideout : Oskar.Rugan.Olly.Zarys.Brem

The Festering Cove : BOOOAL.Pooldripp the Zealous

Arcane Tower : Bernard

Underdark : Baelen Bonecloak.Bernard.Blurg.Derryth Bonecloak.Dhourn.Filro the Forgotten.Gekh Coal.Glut.Omeluum.Sovereign Spaw.Thulla.Arcagh (Petrified Drow).Artimetz (Petrified Drow).Dhourn (Petrified Drow).Izwae (Petrified Drow).Moy (Petrified Drow.Tecothy (Petrified Drow)

Grymforge : Brathwen.Corsair Greymon.Elder Brithvar.Herdmaster Skarjall.Lunkbug.Philomeen.Sergeant Thrinn.Skickpit.Stonemason Kith.True Soul Nere.Ward Magmar

Moonrise Towers : Araj Oblodra.Roah Moonglow.Jaheira.Ketheric Thorm.Nightsong.Dame Aylin.Lann Tarv.Fezzerk.Mig.Linsella.Barnabus.Z'rell.Radija.Glourik.Wulbren.Lia.The Warden.Lakrissa.Cal.Danis

Rosymorn Monastery : Lady Esther

Cr√®che Y'llek : A'jak'nir Jeera.Varsh Ko'kuu.Ch'r'ai W'wargaz.Kith'rak Therezzyn.Sa'varsh Kethk.Youth Varrl

Last Light Inn : Isobel.Art Cullagh.Dammon.Quartermaster Talli.Barcus Wroot.Mattis.Umi.Ide.Mol.Alfira.Cerys.Fist Ulthred.Harper Bor.Harper Elindale.Harper Essius.Harper Manus.Harper Mijah.Harper Skywin

Reithwin Town : Ch'r'ai Tska'an.Raphael.Gerringothe Thorm.Thisobald Thorm.Arabella

Ruined Battlefield : He Who Was.Dolly Dolly Dolly.Elminster Aumar.Oliver

House of Healing : Malus Thorm.Sister Lidwin.Sister Sinda.Locke

Mind Flayer Colony : Zevlor.Us.Chop.Kressa Bonedaughter.Ketheric Thorm.Enver Gortash.Orin

Gauntlet of Shar : Balthazar.Nightsong.Raphael.Dame Aylin.Yurgir.Lyrthindor

Rivington : Ferg Drogher.Orin.Ulma.Manip Nestor.Arfur Gregorio.Gyldro Angleiron the Smith.Lilly Beanbottom.Zenovia Dawg.Mattis.Fist Rowan.Exxvikyap.Danzo Arkwright.Jeffers Morston.Commander Lightfeather.Angry Mar'hyah.Yenna.Manip Falcao.Angry Mar'hyah

Circus of the Last Days : Akabi.Benji.Boney.Dribbles the Clown.Glingo Trapeze-Master.Keren.Klaus.Lens the Journalist.Lucretious.Medrash.Popper.Shadow-Whiskers.Zara the Mummy.Zethino

Angleiron's Cellar : Barcus Wroot.Bumpnagel.Wulbren

Open Hand Temple : Brother Bill.Brother Clements.Brother Donnick.Father Donnick.Father Bills.Father Clements.Novice Bramble.Sister Rose the Penitent.Sister Yannis.Shirra Clarwen.Tara.Valeria

Wyrm's Crossing : Queelia Arvis.Thodric Shedeever.Korrilla.Entharl Danthelon.Stylin' Horst.Carmen Pennygood

Sharess' Caress : Hoots Hooligan.Raphael.Kith'rak Voss.Mamzell Amira.Nym Orlith.Sorn Orlith.Korrilla.Kira the Cat.Naoise Nallinto.Fist Jara.Earspoon.Borgus Elamin

Wyrm's Rock Fortress : Duke Ravengard.Enver Gortash.Mizora.Quartermaster Arkleia Oloril.Fist Reynash

Wyrm's Rock Prison : Counsellor Florrick

Dragon's Sanctum : Emperor.Ansur

Fraygo's Flophouse : Adventurer Drinn.Dalyria.Pale Petras

Carm's Garm : Carm.Naaber

Danthelon's Dancing Axe : Entharl Danthelon

Lower City Sewers : Aelis Siryasius.Arabella.Dairow Vin.Kith'rak Voss.Lorna Esthelian.Helena, Orin's Mother

Basilisk Gate Barracks : Fist Liara Portyr.Lora

Lower City : Oliver Tefoco.Dammon.Rakath Glutterbeard.Helsik.Ch'r'ai Har'rak.Gate Master Ri'zel.Gate Master Zyrlak.Veteran Gish Ghush'ins.Veteran Gish Zhendila.Veteran Raider Ly'iss.Lady Jannath.Oskar Fevras.Tarhun Mnemonis.Adrielle.Jatlo.Kled.Mayrina.Cora Highberry.Dolor.Molly the Orphan.Muttonchomps Oreelly.Porter Oveer.Roger Highberry.Timmy the Orphan.Redhammer.Rakath Glitterbeard

Szarr Palace : Cazador.Chamberlain Dufay.Lurianna Sauvage.Valderola.Vilhelm

Cloister of Sombre Embrace : Emmeline Hallowleaf.Arnell Hallowleaf.Viconia DeVir.Nocturne

Iron Throne : Omeluum.Duke Ravengard

House of Hope : Archivist.Hope.Haarlep.Nubaldin.Raphael

Sorcerous Sundries : Lorroakan's Projection.Lorroakan.Rolan.Tolna Tome-Monger

Steel Watch Foundry : Zanner Toobin.Tamia Holzt

Stormshore Armoury : Gloomy Fentonson.Fytz the Firecracker

Stormshore Tabernacle : Vicar Humbletoes

Guildhall : Mol.Nine-Fingers Keene.Bad Twin Bubbins.Elliot.Carlorina the Wolf (Zhentarim).Fishbait Arno (Zhentarim).Follgast (Zhentarim).Lacy Dancer (Zhentarim).Slick Inatra (Zhentarim).Smilin' Ginna (Zhentarim).Severn

Elfsong Tavern : Alfira.Harvard Willoughby.Alan Alyth

Blushing Mermaid : Auntie Ethel.Captain Grisly.Vanra

Water Queen's House : Allandra Grey  

Animal NPCs in Baldur's Gate 3 :  In order to speak to animal NPCs, you need Speak with Animals potion or spell.